1111111111111
1202020202021
1111111110101
1202020202121
1011111011111
1202120213021
1010111110101
1212020212121
1011111011101
1212020202121
1010111111101
1212020302021
1111111111111