1111111111111
1302120202021
1010111111101
1212120202021
1010101111101
1212021202121
1011111011101
1312020202021
1011111111101
1202020202121
1011111110101
1202021202121
1111111111111