1111111111111
1203020212021
1011111010101
1212021202121
1010111111101
1202120212021
1111101110111
1202120202121
1010101111101
1212120202121
1011111110101
1203020202021
1111111111111