1111111111111
1202021202021
1011101011111
1312021202021
1010111111101
1212021202031
1011101011101
1212020212021
1011111111101
1202021202121
1011101011101
1202120212021
1111111111111