1111111111111
1212020202021
1010111110101
1212130212121
1010101110101
1202021202121
1011111011101
1212120212021
1010101111101
1312121202121
1010101010111
1202120212021
1111111111111