1111111111111
1202021202021
1110111010111
1202120213021
1011101111101
1212021202021
1010111011101
1203120212121
1011101110101
1212121202121
1010101011101
1212021202021
1111111111111