1111111111111
1212020312021
1010111010101
1202021202121
1011111111101
1212020202121
1010111110101
1212031202021
1011101111111
1212120202021
1010111111111
1202020202021
1111111111111