1111111111111
1202021212021
1011101010101
1212121202121
1110101111101
1202121202121
1010101010101
1212121312131
1010101010101
1212021212121
1011111010101
1202020212021
1111111111111