1111111111111
1212021203021
1010101110101
1212121202121
1010101011101
1202121212021
1011111010111
1202120212121
1110101010101
1202131212021
1011111011101
1202020212021
1111111111111